1111111111111111111
11P000000000000C111
1111110C11111011111
1111110111110011111
11111000C1110111111
11110C0111110111111
1C000000000C00000C1
1110111111111000111
1E0000000C0000000C1
1111111111111111111
